//! STRINGS.TXT REFERENCE FILE: make a copy, remove this line, and follow the instructions to add/update languages -- Autogenerated, Last Updated: 2023-02-24T18:21:11.311260+00:00

//! This file must be encoded with UTF-8 (e.g. with Windows Notepad)
//! LICENSE: This localization file is part of JPEGView <https://github.com/sylikc/jpegview> and distributed under the same license.  See <https://github.com/sylikc/jpegview/blob/master/LICENSE.txt> for more info.

//! Filename Convention: 'strings_%languagecode%.txt' where %languagecode% is the ISO 639 language code e.g. 'en' for English

////////////////////
// ::: Translation Info ::: //
//: ISO 639 code: ko
//: Language: Korean
//: Translator(s): VenusGirl (ë¹„ë„ˆìŠ¤ê±¸)ğŸ’‹
//: Last Updated:
//: Additional Notes:
////////////////////

////////////////////
// ::: Instructions / Help ::: (help for translators only, does not need to be translated) //

//? Line Format:    English string<tab>Translated string<newline>
//? * Lines beginning with "//" (comments) are ignored
//? * Blank lines are ignored
//? * Lines without a <tab> are ignored
//? * Lines with no text after the <tab> are ignored
//? * Multiple tabs are permitted between English and Translated string, e.g. this is valid:    English string<tab><tab><tab>Translated string<newline>

//? NOTE: %s %d have special meanings in the strings, so make sure they appear somewhere in the translated string

//? For the strings below which are short and have no context:
//?   "in" in context is shorthand for "inch"
//?   "cm" in context is shorthand for "centimeter"
//?   "C - R" in context is "Cyan Red" colors
//?   "M - G" in context is "Magenta Green" colors
//?   "Y - B" in context is "Yellow Blue" colors
//?   "yes"/"no" in context is for showing EXIF flags
//?   "on"/"off" in context is for showing a setting active or not
////////////////////


// ::: Program Strings ::: (sorted alphabetically) //
%d file(s) renamed, %d file(s) copied, %d folder(s) created	dê°œì˜ íŒŒì¼ ì´ë¦„ ë³€ê²½, %dê°œì˜ íŒŒì¼ ë³µì‚¬, %dê°œì˜ í´ë” ìƒì„±
%s camera raw images (embedded JPEGs only)	%s ì¹´ë©”ë¼ ì›ì‹œ ì´ë¯¸ì§€ (ë‚´ì¥ëœ JPEGì—ë§Œ í•´ë‹¹)
%s images	%s ì´ë¯¸ì§€
%s images (processed by Window Imaging Component - WIC)	%s ì´ë¯¸ì§€ (Window Imaging Component - WICì—ì„œ ì²˜ë¦¬)
'My Pictures' folder	'ë‚´ ì‚¬ì§„' í´ë”
About JPEGView (32-bit version)...	JPEGView (32ë¹„íŠ¸ ë²„ì „) í•œêµ­ì–´ ì •ë³´ - ë²ˆì—­: ë¹„ë„ˆìŠ¤ê±¸...
About JPEGView (64-bit version)...	JPEGView (64ë¹„íŠ¸ ë²„ì „) í•œêµ­ì–´ ì •ë³´ - ë²ˆì—­: ë¹„ë„ˆìŠ¤ê±¸...
Acquisition date:	ì´¬ì˜ ë‚ ì§œ:
Actual size of image	ì´ë¯¸ì§€ì˜ ì‹¤ì œ í¬ê¸°
Align image to horizontal or vertical line	ì´ë¯¸ì§€ë¥¼ ìˆ˜í‰ì„  ë˜ëŠ” ìˆ˜ì§ì„ ì— ë§ì¶”ê¸°
Alignment:	ì •ë ¬
All Files	ëª¨ë“  íŒŒì¼
All existing user settings will be preserved.	ê¸°ì¡´ì˜ ëª¨ë“  ì‚¬ìš©ì ì„¤ì •ì´ ë³´ì¡´ë©ë‹ˆë‹¤.
Alternatively, right-click an image file of the given type in Windows Explorer and select 'Open with... > Choose default program'	ë˜ëŠ” Windows íƒìƒ‰ê¸°ì—ì„œ ì§€ì •ëœ ìœ í˜•ì˜ ì´ë¯¸ì§€ íŒŒì¼ì„ ë§ˆìš°ìŠ¤ ì˜¤ë¥¸ìª½ ë²„íŠ¼ìœ¼ë¡œ í´ë¦­í•˜ê³  'ë‹¤ìŒìœ¼ë¡œ ì—´ê¸°...'ë¥¼ ì„ íƒ... > ê¸°ë³¸ í”„ë¡œê·¸ë¨ ì„ íƒ'
Altitude (m):	ê³ ë„ (m):
Amount	ì–‘
Application:	ì‘ìš© í”„ë¡œê·¸ë¨
Applications	ì‘ìš© í”„ë¡œê·¸ë¨
Apply	ì ìš©
Apply Unsharp Mask	ì„ ëª…í•˜ì§€ ì•Šì€ ë§ˆìŠ¤í¬ ì ìš©
Apply auto contrast correction using only visible section of image	ì´ë¯¸ì§€ì˜ ë³´ì´ëŠ” ë¶€ë¶„ë§Œ ì‚¬ìš©í•˜ì—¬ ìë™ ëŒ€ë¹„ ë³´ì • ì ìš©
Ascending	ì˜¤ë¦„ì°¨ìˆœ
Auto contrast and color correction	ìë™ ëŒ€ë¹„ ë° ìƒ‰ìƒ ë³´ì •
Auto crop corrected image (avoids black border)	ë³´ì •ëœ ì´ë¯¸ì§€ ìë™ ìë¥´ê¸° (ê²€ì€ í…Œë‘ë¦¬ ë°©ì§€)
Auto crop rotated image (avoids black border)	íšŒì „ëœ ì´ë¯¸ì§€ ìë™ ìë¥´ê¸° (ê²€ì€ìƒ‰ í…Œë‘ë¦¬ ì‚¬ìš© ì•ˆ í•¨)
Auto zoom mode	ìë™ í™•ëŒ€/ì¶•ì†Œ ëª¨ë“œ
Back mouse button	ë§ˆìš°ìŠ¤ ë’¤ë¡œ ë²„íŠ¼
Batch rename/copy of files	ì¼ê´„ íŒŒì¼ ì´ë¦„ ë°”ê¾¸ê¸°/ë³µì‚¬
Blend	í˜¼í•©
Bottom	ë§¨ ì•„ë˜
Box	ìƒì
Brightness	ë°ê¸°
Browse...	ì°¾ì•„ë³´ê¸°...
C - R	C - R
Camera model:	ì¹´ë©”ë¼ ëª¨ë¸:
Can't rename file	íŒŒì¼ ì´ë¦„ì„ ë°”ê¿€ ìˆ˜ ì—†ìŠµë‹ˆë‹¤
Cancel	ì·¨ì†Œ
Cannot read from parameter DB file '%s'!	ë§¤ê°œë³€ìˆ˜ DB íŒŒì¼ '%s'ì—ì„œ ì½ì„ ìˆ˜ ì—†ìŠµë‹ˆë‹¤!
Cannot read parameter DB file '%s' because it is too large!	ë§¤ê°œë³€ìˆ˜ DB íŒŒì¼ '%s'ì´(ê°€) ë„ˆë¬´ ì»¤ì„œ ì½ì„ ìˆ˜ ì—†ìŠµë‹ˆë‹¤!
Cannot write to parameter DB file '%s'!	ë§¤ê°œë³€ìˆ˜ DB íŒŒì¼ '%s'ì— ì“¸ ìˆ˜ ì—†ìŠµë‹ˆë‹¤!
Click and drag the mouse vertically to correct image tilt.	ë§ˆìš°ìŠ¤ë¥¼ í´ë¦­í•˜ê³  ìˆ˜ì§ìœ¼ë¡œ ëŒì–´ì„œ ì´ë¯¸ì§€ ê¸°ìš¸ê¸°ë¥¼ ìˆ˜ì •í•©ë‹ˆë‹¤.
Clipboard Image	í´ë¦½ë³´ë“œ ì´ë¯¸ì§€
Close	ë‹«ê¸°
Close help text display / Close JPEGView	ë„ì›€ë§ í‘œì‹œ ë‹«ê¸° / JPEGView ë‹«ê¸°
Color Correction	ìƒ‰ìƒ ë³´ì •
Combine keys with '+'	í‚¤ë¥¼ '+'ì™€ ê²°í•©
Confirm	í™•ì¸
Confirm save default parameters	ê¸°ë³¸ ë§¤ê°œë³€ìˆ˜ ì €ì¥ í™•ì¸
Conflicting entries in Param DB	ë§¤ê°œë³€ìˆ˜ DBì—ì„œ ì¶©ëŒí•˜ëŠ” í•­ëª©
Continue rename/copy?	ì´ë¦„ ë°”ê¾¸ê¸°/ë³µì‚¬ë¥¼ ê³„ì†í•˜ì‹œê² ìŠµë‹ˆê¹Œ?
Contrast	ëŒ€ë¹„
Contrast Correction	ëŒ€ë¹„ ë³´ì •
Copy file path of the image to clipboard	ì´ë¯¸ì§€ì˜ íŒŒì¼ ê²½ë¡œë¥¼ í´ë¦½ë³´ë“œì— ë³µì‚¬
Copy screen to clipboard/ Copy processed full size image to clipboard	í™”ë©´ì„ í´ë¦½ë³´ë“œë¡œ ë³µì‚¬/ì²˜ë¦¬ëœ ì „ì²´ í¬ê¸° ì´ë¯¸ì§€ë¥¼ í´ë¦½ë³´ë“œë¡œ ë³µì‚¬
Copying parameter DB to file '%s' failed. Reason: %s	ë§¤ê°œë³€ìˆ˜ DBë¥¼ '%s' íŒŒì¼ë¡œ ë³µì‚¬í•˜ì§€ ëª»í–ˆìŠµë‹ˆë‹¤. ì´ìœ : %s
Correct converging lines (perspective correction)	ìˆ˜ë ´ ì„  ìˆ˜ì • (ì›ê·¼ ë³´ì •)
Creation date/time	ë§Œë“  ë‚ ì§œ/ì‹œê°
Crop image	ì´ë¯¸ì§€ ìë¥´ê¸°
Ctrl + Left mouse	Ctrl + ì™¼ìª½ ë§ˆìš°ìŠ¤
Current image	í˜„ì¬ ì´ë¯¸ì§€
Cyan-Red	ì²­ë¡ìƒ‰-ë¹¨ê°„ìƒ‰
Darken Highlights	í•˜ì´ë¼ì´íŠ¸ ì–´ë‘¡ê²Œ
Date	ë‚ ì§œ
Date placeholders use the modification date of the image.	ë‚ ì§œ ìë¦¬ í‘œì‹œìëŠ” ì´ë¯¸ì§€ì˜ ìˆ˜ì • ë‚ ì§œë¥¼ ì‚¬ìš©í•©ë‹ˆë‹¤.
Day / Month / Year (as numbers)	ì¼ / ì›” / ë…„ (ìˆ«ìë¡œ)
Decoding this format requires the Microsoft Visual C++ Redistributable.	ì´ í˜•ì‹ì„ ë””ì½”ë”©í•˜ë ¤ë©´ Microsoft Visual C++ ì¬ë°°í¬ ê°€ëŠ¥ íŒŒì¼ì´ í•„ìš”í•©ë‹ˆë‹¤.
Deep Shadows	ìŒì˜ ê¹Šê²Œ
Delete	ì‚­ì œ
Delete current file on disk permanently	í˜„ì¬ íŒŒì¼ì„ ë””ìŠ¤í¬ì—ì„œ ì˜êµ¬íˆ ì‚­ì œ
Delete image file	ì´ë¯¸ì§€ íŒŒì¼ ì‚­ì œ
Descending	ë‚´ë¦¼ì°¨ìˆœ
Display image (EXIF) information	ì´ë¯¸ì§€ ì •ë³´ (EXIF) í‘œì‹œ
Do you really want to delete the current image file on disk?	ë””ìŠ¤í¬ì˜ í˜„ì¬ ì´ë¯¸ì§€ íŒŒì¼ì„ ì‚­ì œí•˜ì‹œê² ìŠµë‹ˆê¹Œ?
Do you really want to permanently delete the file %filename%?	%filename% íŒŒì¼ì„ ì˜êµ¬ì ìœ¼ë¡œ ì‚­ì œí•˜ì‹œê² ìŠµë‹ˆê¹Œ?
Do you really want to save the following parameters as default to the INI file	ë‹¤ìŒ ë§¤ê°œë³€ìˆ˜ë¥¼ INI íŒŒì¼ì— ê¸°ë³¸ê°’ìœ¼ë¡œ ì €ì¥í•˜ì‹œê² ìŠµë‹ˆê¹Œ
Drag at the left or right border for asymmetric correction.	ë¹„ëŒ€ì¹­ ë³´ì •ì„ ìœ„í•´ ì™¼ìª½ ë˜ëŠ” ì˜¤ë¥¸ìª½ í…Œë‘ë¦¬ì—ì„œ ë•ë‹ˆë‹¤.
EXIF date successfully set on %d images, failed on %d images	EXIF ë‚ ì§œê°€ %dê°œ ì´ë¯¸ì§€ì— ì„¤ì •ë˜ì—ˆìŠµë‹ˆë‹¤. %dê°œ ì´ë¯¸ì§€ì— ì‹¤íŒ¨í–ˆìŠµë‹ˆë‹¤
Edit	í¸ì§‘
Enable/disable automatic contrast correction (histogram equalization)	ìë™ ëŒ€ë¹„ ë³´ì • í™œì„±í™”/ë¹„í™œì„±í™” (íˆìŠ¤í† ê·¸ë¨ ê· ë“±í™”)
Enable/disable automatic density correction (local brightness correction)	ìë™ ë†ë„ ë³´ì • í™œì„±í™”/ë¹„í™œì„±í™” (êµ­ì†Œ ë°ê¸° ë³´ì •)
Enable/disable full screen mode	ì „ì²´ í™”ë©´ ëª¨ë“œ í™œì„±í™”/ë¹„í™œì„±í™”
Enable/disable high quality resampling	ê³ í’ˆì§ˆ ì¬ìƒ˜í”Œë§ í™œì„±í™”/ë¹„í™œì„±í™”
Enable/disable keeping of geometry related (zoom/pan/rotation)	ì§€ì˜¤ë©”íŠ¸ë¦¬ ê´€ë ¨ ìœ ì§€ í™œì„±í™”/ë¹„í™œì„±í™” (í™•ëŒ€/ì´ë™/íšŒì „)
Enable/disable landscape picture enhancement mode	ê°€ë¡œ ì‚¬ì§„ í–¥ìƒ ëª¨ë“œ í™œì„±í™”/ë¹„í™œì„±í™”
Error	ì˜¤ë¥˜
Error during rename/copy	ì´ë¦„ ë°”ê¾¸ê¸°/ë³µì‚¬ ì¤‘ ì˜¤ë¥˜
Error saving file	íŒŒì¼ ì €ì¥ ì¤‘ ì˜¤ë¥˜
Error while writing the following registry key	ë‹¤ìŒ ë ˆì§€ìŠ¤íŠ¸ë¦¬ í‚¤ë¥¼ ì“°ëŠ” ë™ì•ˆ ì˜¤ë¥˜
Error writing file to disk!	ë””ìŠ¤í¬ì— íŒŒì¼ì„ ì“°ëŠ” ë™ì•ˆ ì˜¤ë¥˜ê°€ ë°œìƒí–ˆìŠµë‹ˆë‹¤!
Example:	ì˜ˆ:
Exposure bias (EV):	ë…¸ì¶œ ë³´ì • (EV):
Exposure time (s):	ë…¸ì¶œ ì‹œê°„ (ì´ˆ):
Extension	í™•ì¥
Extracted number from original file name	ì›ë³¸ íŒŒì¼ ì´ë¦„ì—ì„œ ì¶”ì¶œëœ ë²ˆí˜¸
F-Number:	F ë²ˆí˜¸:
File name	íŒŒì¼ ì´ë¦„
File size	íŒŒì¼ í¬ê¸°
File type	íŒŒì¼ ìœ í˜•
Fill paper with crop	ìë¥´ê¸°ë¡œ ìš©ì§€ ì±„ìš°ê¸°
Fill with crop	ìë¥´ê¸°ë¡œ ì±„ìš°ê¸°
Fill with crop (no zoom)	ìë¥´ê¸°ë¡œ ì±„ìš°ê¸° (í™•ëŒ€/ì¶•ì†Œ ì—†ìŒ)
Filter:	í•„í„°
Fit image to screen	í™”ë©´ì— ì´ë¯¸ì§€ ë§ì¶”ê¸°
Fit to paper	ìš©ì§€ì— ë§ì¶”ê¸°
Fit to screen	í™”ë©´ì— ë§ì¶”ê¸°
Fit to screen (no zoom)	í™”ë©´ì— ë§ì¶”ê¸° (í™•ëŒ€/ì¶•ì†Œ ì—†ìŒ)
Flash fired:	í”Œë˜ì‹œ ë°œê´‘:
Focal length (mm):	ì´ˆì  ê±°ë¦¬ (mm):
Forward mouse button	ë§ˆìš°ìŠ¤ ì•ìœ¼ë¡œ ë²„íŠ¼
Full screen mode	ì „ì²´ í™”ë©´ ëª¨ë“œ
Goto first/last image of current folder (using sort order as defined)	í˜„ì¬ í´ë”ì˜ ì²« ë²ˆì§¸/ë§ˆì§€ë§‰ ì´ë¯¸ì§€ë¡œ ì´ë™ (ì •ì˜ëœ ì •ë ¬ ìˆœì„œ ì‚¬ìš©)
Goto next image	ë‹¤ìŒ ì´ë¯¸ì§€ë¡œ ì´ë™
Goto previous image	ì´ì „ ì´ë¯¸ì§€ë¡œ ì´ë™
Height	ë†’ì´
Hide histogram	íˆìŠ¤í† ê·¸ë¨ ìˆ¨ê¸°ê¸°
High quality resampling	ê³ í’ˆì§ˆ ë¦¬ìƒ˜í”Œë§
Hour / Minute (as numbers)	ì‹œê°„/ë¶„ (ìˆ«ì)
ISO Speed:	ISO ì†ë„:
Image Pixels	ì´ë¯¸ì§€ í”½ì…€
Image files in folder	í´ë”ì˜ ì´ë¯¸ì§€ íŒŒì¼
Image height:	ì´ë¯¸ì§€ ë†’ì´:
Image width and height must be dividable by the JPEG block size (8 or 16) for lossless transformations!	ë¬´ì†ì‹¤ ë³€í™˜ì„ ìœ„í•´ì„œëŠ” ì´ë¯¸ì§€ í­ê³¼ ë†’ì´ë¥¼ JPEG ë¸”ë¡ í¬ê¸° (8 ë˜ëŠ” 16)ë¡œ ë‚˜ëˆŒ ìˆ˜ ìˆì–´ì•¼ í•©ë‹ˆë‹¤!
Image width:	ì´ë¯¸ì§€ ë„ˆë¹„:
Images	ì´ë¯¸ì§€
Increase/decrease auto color cast correction amount	ìë™ ìƒ‰ìƒ ë³´ì •ëŸ‰ ì¦ê°€/ê°ì†Œ
Increase/decrease auto contrast correction amount	ìë™ ëŒ€ë¹„ ë³´ì •ëŸ‰ ì¦ê°€/ê°ì†Œ
Increase/decrease brightness	ë°ê¸° ì¦ê°€/ê°ì†Œ
Increase/decrease contrast	ëŒ€ë¹„ ì¦ê°€/ê°ì†Œ
Increase/decrease darkening of highlights (LDC must be on)	í•˜ì´ë¼ì´íŠ¸ì˜ ì–´ë‘¡ê¸° ì¦ê°€/ê°ì†Œ (ë¶€ë¶„ ë†ë„ ë³´ì •ì´ ì¼œì ¸ìˆì–´ì•¼ í•¨)
Increase/decrease lightening of shadows (LDC must be on)	ê·¸ë¦¼ìì˜ ë°ê¸° ì¦ê°€/ê°ì†Œ (ë¶€ë¶„ ë†ë„ ë³´ì •ì´ ì¼œì ¸ìˆì–´ì•¼ í•¨)
Increase/decrease sharpness	ì„ ëª…í•˜ê²Œ ì¦ê°€/ê°ì†Œ
Insufficient rights to change the privilege (DACL) on the registry entry. Continue?	ë ˆì§€ìŠ¤íŠ¸ë¦¬ í•­ëª©ì— ëŒ€í•œ ê¶Œí•œ (DACL)ì„ ë³€ê²½í•  ìˆ˜ ìˆëŠ” ê¶Œí•œì´ ë¶€ì¡±í•©ë‹ˆë‹¤. ê³„ì†í•˜ì‹œê² ìŠµë‹ˆê¹Œ?
JPEGView Help	JPEGView ë„ì›€ë§
JPEGView is a lean, fast and highly configurable viewer/editor for JPEG, BMP, PNG, WEBP, TGA, GIF and TIFF images with a minimal GUI.	JPEG ViewëŠ” ìµœì†Œí•œì˜ GUIë¡œ JPEG, BMP, PNG, WEBP, TGA, GIF ë° TIFF ì´ë¯¸ì§€ë¥¼ ìœ„í•œ ì–‡ê³  ë¹ ë¥´ê³  êµ¬ì„± ê°€ëŠ¥í•œ ë·°ì–´/í¸ì§‘ê¸°ì…ë‹ˆë‹¤.
JPEGView is registered as default viewer for the selected file formats.	JPEGViewëŠ” ì„ íƒí•œ íŒŒì¼ í˜•ì‹ì— ëŒ€í•œ ê¸°ë³¸ ë·°ì–´ë¡œ ë“±ë¡ë©ë‹ˆë‹¤.
Keep aspect ratio on crop	ìë¥´ê¸°ì˜ ê°€ë¡œ ì„¸ë¡œ ë¹„ìœ¨ ìœ ì§€
Keep parameters	ë§¤ê°œë³€ìˆ˜ ìœ ì§€
Keep processing parameters between images	ì´ë¯¸ì§€ ê°„ ì²˜ë¦¬ ë§¤ê°œë³€ìˆ˜ ìœ ì§€
Known keys:	ì•Œë ¤ì§„ í‚¤:
Lanczos/Bicubic	ë€ì´ˆìŠ¤/ë¹„íë¹…
Landscape	ê°€ë¡œ
Landscape picture enhancement mode	ê°€ë¡œ ì‚¬ì§„ í–¥ìƒ ëª¨ë“œ
Last modification date/time	ë§ˆì§€ë§‰ ìˆ˜ì •í•œ ë‚ ì§œ/ì‹œê°
Left	ì™¼ìª½
Left mouse & drag	ì™¼ìª½ ë§ˆìš°ìŠ¤ ë° ëŒê¸°
Licensed under the GNU general public license (GPL), see readme file for details	GNU ì¼ë°˜ ê³µì¤‘ ì‚¬ìš© í—ˆê°€ì„œ (GPL)ì— ë”°ë¼ ë¼ì´ì„ ìŠ¤ê°€ ë¶€ì—¬ë˜ë©°, ìì„¸í•œ ë‚´ìš©ì€ readme íŒŒì¼ ì°¸ì¡°
Lighten Shadows	ìŒì˜ ë°ê²Œ
Local density correction	ë¶€ë¶„ ë°€ë„ ë³´ì •
Location:	ìœ„ì¹˜
Loop folder	í´ë” ìˆœí™˜
Loop recursively	ë°˜ë³µ ìˆœí™˜
Loop siblings	ë™ê¸° ìˆœí™˜
Loop through files in current directory and all sibling folders (folders on same level)	í˜„ì¬ ë””ë ‰í„°ë¦¬ ë° ëª¨ë“  í˜•ì œ í´ë” (ë™ì¼í•œ ìˆ˜ì¤€ì˜ í´ë”)ì— ìˆëŠ” íŒŒì¼ ìˆœí™˜
Loop through files in current directory and all subfolders	í˜„ì¬ ë””ë ‰í„°ë¦¬ ë° ëª¨ë“  í•˜ìœ„ í´ë”ì˜ íŒŒì¼ ë£¨í”„
Loop through files in current folder	í˜„ì¬ í´ë”ì˜ íŒŒì¼ ìˆœí™˜
Lossless JPEG transformations	ë¬´ì†ì‹¤ JPEG ë³€í™˜
M - G	M - G	
Magenta-Green	ìí™ìƒ‰-ë…¹ìƒ‰
Manage 'Open image with' menu...	''ë‹¤ìŒìœ¼ë¡œ ì´ë¯¸ì§€ ì—´ê¸°' ë©”ë‰´ ê´€ë¦¬...
Margins:	ì—¬ë°±:
Mark image for toggling. Use %s to toggle between marked and current image	ì „í™˜í•  ì´ë¯¸ì§€ë¥¼ í‘œì‹œí•©ë‹ˆë‹¤. %sì„(ë¥¼) ì‚¬ìš©í•˜ì—¬ í‘œì‹œëœ ì´ë¯¸ì§€ì™€ í˜„ì¬ ì´ë¯¸ì§€ ê°„ ì „í™˜
Maximize/restore to/from virtual desktop (only for multi-monitor systems)	ê°€ìƒ ë°ìŠ¤í¬í†± ìµœëŒ€í™”/ë³µì›(ë©€í‹° ëª¨ë‹ˆí„° ì‹œìŠ¤í…œì—ë§Œ í•´ë‹¹)
Menu entries:	ë©”ë‰´ í•­ëª©:
Modification date:	ìˆ˜ì • ë‚ ì§œ:
Modifier keys:	
Month / Short form (text)	ì›” / ë‹¨ì¶•í˜• (í…ìŠ¤íŠ¸)
Mouse wheel	ë§ˆìš°ìŠ¤ íœ 
Navigation	íƒìƒ‰
New	ìƒˆë¡œ ë§Œë“¤ê¸°
New height:	ìƒˆ ë†’ì´
New name (>> : file gets copied)	ìƒˆ ì´ë¦„ (>> : íŒŒì¼ì´ ë³µì‚¬ë¨)
New name contains backslash character!	ìƒˆ ì´ë¦„ì— ë°±ìŠ¬ë˜ì‹œ ë¬¸ìê°€ í¬í•¨ë˜ì–´ ìˆìŠµë‹ˆë‹¤!
New size:	ìƒˆ í¬ê¸°
New width:	ìƒˆ ë„ˆë¹„
Next image	ë‹¤ìŒ ì´ë¯¸ì§€
No image loaded!	ì´ë¯¸ì§€ê°€ ë¡œë“œë˜ì§€ ì•Šì•˜ìŠµë‹ˆë‹¤!
No user INI file exists yet. Create user INI file from INI file template?	ì‚¬ìš©ì INI íŒŒì¼ì´ ì•„ì§ ì—†ìŠµë‹ˆë‹¤. INI íŒŒì¼ í…œí”Œë¦¿ì—ì„œ ì‚¬ìš©ì INI íŒŒì¼ì„ ìƒì„±í•˜ì‹œê² ìŠµë‹ˆê¹Œ?
None	ì—†ìŒ
Not enough memory available	ì‚¬ìš© ê°€ëŠ¥í•œ ë©”ëª¨ë¦¬ê°€ ë¶€ì¡±í•©ë‹ˆë‹¤
Note: Set the key 'TrimWithoutPromptLosslessJPEG=true' in the INI file to always trim without showing this message.	ì°¸ê³ : ì´ ë©”ì‹œì§€ë¥¼ í‘œì‹œí•˜ì§€ ì•Šê³  í•­ìƒ ìë¥´ë ¤ë©´ INI íŒŒì¼ì—ì„œ 'TrimWithoutPromptLosslessJPEG=true' í‚¤ë¥¼ ì„¤ì •í•˜ì„¸ìš”.
Number (consecutively numbered)	ë²ˆí˜¸ (ì—°ì† ë²ˆí˜¸)
Number of CPU cores used	ì‚¬ìš©ëœ CPU ì½”ì–´ ìˆ˜
Number of JPEG files in folder: %d	í´ë”ì— ìˆëŠ” JPEG íŒŒì¼ ìˆ˜: %d
Number with N digits	Nìë¦¬ ìˆ«ì
OK	í™•ì¸
Old name	ì´ì „ ì´ë¦„
Open folder containing image and select in Windows Explorer	ì´ë¯¸ì§€ê°€ í¬í•¨ëœ í´ë”ë¥¼ ì—´ê³  Windows íƒìƒ‰ê¸°ì—ì„œ ì„ íƒ
Open new image or slideshow file	ìƒˆ ì´ë¯¸ì§€ ë˜ëŠ” ìŠ¬ë¼ì´ë“œ ì‡¼ íŒŒì¼ ì—´ê¸°
Order files by	íŒŒì¼ ì •ë ¬
Orientation:	ë°©í–¥
Original file extension	ì›ë³¸ íŒŒì¼ í™•ì¥ì
Original file name (with extension)	ì›ë³¸ íŒŒì¼ëª… (í™•ì¥ì ìˆìŒ)
Original file name (without extension)	ì›ë³¸ íŒŒì¼ëª… (í™•ì¥ì ì—†ìŒ)
Pan image	ì´ë¯¸ì§€ ì´ë™
Paper:	ìš©ì§€
Parameter DB	ë§¤ê°œë³€ìˆ˜ DB
Parameter DB error	ë§¤ê°œë³€ìˆ˜ DB ì˜¤ë¥˜
Parameter DB file '%s' could not be opened!	ë§¤ê°œë³€ìˆ˜ DB íŒŒì¼ '%s'ì„(ë¥¼) ì—´ ìˆ˜ ì—†ìŠµë‹ˆë‹¤!
Parameter DB file '%s' is not valid (invalid header)!	'%s' ë§¤ê°œë³€ìˆ˜ DB íŒŒì¼ì´ ì˜ëª»ë˜ì—ˆìŠµë‹ˆë‹¤ (ì˜ëª»ëœ í—¤ë”)!
Paste from clipboard	í´ë¦½ë³´ë“œì—ì„œ ë¶™ì—¬ë„£ê¸°
Pasting image from clipboard failed!	í´ë¦½ë³´ë“œì—ì„œ ì´ë¯¸ì§€ë¥¼ ë¶™ì—¬ë„£ì§€ ëª»í–ˆìŠµë‹ˆë‹¤!
Performing the lossless transformation failed!	ë¬´ì†ì‹¤ ë³€í™˜ì„ ìˆ˜í–‰í•˜ì§€ ëª»í–ˆìŠµë‹ˆë‹¤!
Performing the transformation failed	ë³€í™˜ì„ ìˆ˜í–‰í•˜ì§€ ëª»í–ˆìŠµë‹ˆë‹¤
Perspective Correction	ì›ê·¼ ë³´ì •
Pixels	í”½ì…€
Placeholders:	ìë¦¬ í‘œì‹œì:
Portrait	ì„¸ë¡œ
Press 'OK' to continue with registration or 'Cancel' to abort all registrations.	ë“±ë¡ì„ ê³„ì†í•˜ë ¤ë©´ 'í™•ì¸'ì„ ëˆ„ë¥´ê³  ëª¨ë“  ë“±ë¡ì„ ì¤‘ë‹¨í•˜ë ¤ë©´ 'ì·¨ì†Œ'ë¥¼ ëˆ„ë¥´ì‹­ì‹œì˜¤.
Press ESC to exit...	ì¢…ë£Œí•˜ë ¤ë©´ ESCë¥¼ ëˆ„ë¥´ì‹­ì‹œì˜¤...
Press any key to search the subdirectories for image files.	í•˜ìœ„ ë””ë ‰í„°ë¦¬ì—ì„œ ì´ë¯¸ì§€ íŒŒì¼ì„ ê²€ìƒ‰í•˜ë ¤ë©´ ì•„ë¬´ í‚¤ë‚˜ ëˆ„ë¦…ë‹ˆë‹¤.
Preview	ë¯¸ë¦¬ë³´ê¸°
Previous image	ì´ì „ ì´ë¯¸ì§€
Print	ì¸ì‡„
Print Image	ì´ë¯¸ì§€ ì¸ì‡„
Printer driver	í”„ë¦°í„° ë“œë¼ì´ë²„
Printer:	í”„ë¦°í„°
Project home page	í”„ë¡œì íŠ¸ í™ˆí˜ì´ì§€
Radius	ë°˜ì§€ë¦„
Random	ë¬´ì‘ìœ„
Reading the JPEG file from disk failed	ë””ìŠ¤í¬ì—ì„œ JPEG íŒŒì¼ì„ ì½ì§€ ëª»í–ˆìŠµë‹ˆë‹¤
Reason:	ì´ìœ :
Registering or unregistering file extensions in this registry area requires administrator privileges and cannot be done in JPEGView.	ì´ ë ˆì§€ìŠ¤íŠ¸ë¦¬ ì˜ì—­ì—ì„œ íŒŒì¼ í™•ì¥ëª…ì„ ë“±ë¡í•˜ê±°ë‚˜ ë“±ë¡ ì·¨ì†Œí•˜ë ¤ë©´ ê´€ë¦¬ì ê¶Œí•œì´ í•„ìš”í•˜ë¯€ë¡œ JPEG Viewì—ì„œ ìˆ˜í–‰í•  ìˆ˜ ì—†ìŠµë‹ˆë‹¤.
Registration applies to the current user only.	ë“±ë¡ì€ í˜„ì¬ ì‚¬ìš©ìì—ê²Œë§Œ ì ìš©ë©ë‹ˆë‹¤.
Remove from	ì œê±°
Rename	ì´ë¦„ ë°”ê¾¸ê¸°
Rename/copy images to:	ì´ë¯¸ì§€ ì´ë¦„ ë°”ê¾¸ê¸°/ë³µì‚¬:
Renaming file failed!	íŒŒì¼ ì´ë¦„ì„ ë°”ê¾¸ì§€ ëª»í–ˆìŠµë‹ˆë‹¤!
Reset	ì¬ì„¤ì •
Resize Image	ì´ë¯¸ì§€ í¬ê¸° ì¡°ì •
Right	ì˜¤ë¥¸ìª½
Right mouse button: Context menu	ë§ˆìš°ìŠ¤ ì˜¤ë¥¸ìª½ ë²„íŠ¼: ìƒí™©ì— ë§ëŠ” ë©”ë‰´
Roll from bottom	ì•„ë˜ì—ì„œ êµ´ë¦¬ê¸°
Roll from left	ì™¼ìª½ì—ì„œ êµ´ë¦¬ê¸°
Roll from right	ì˜¤ë¥¸ìª½ì—ì„œ êµ´ë¦¬ê¸°
Roll from top	ìœ„ì—ì„œ êµ´ë¦¬ê¸°
Rotate Image	ì´ë¯¸ì§€ íšŒì „
Rotate current file on disk lossless by 270 deg (W/H must be multiple of 16)	ë””ìŠ¤í¬ì˜ í˜„ì¬ íŒŒì¼ì„ ë¬´ì†ì‹¤ë¡œ 270ë„ íšŒì „ (ë„ˆë¹„/ë†’ì´ëŠ” 16ì˜ ë°°ìˆ˜ì—¬ì•¼ í•¨)
Rotate current file on disk lossless by 90 deg (W/H must be multiple of 16)	ë””ìŠ¤í¬ì˜ í˜„ì¬ íŒŒì¼ì„ ë¬´ì†ì‹¤ë¡œ 90ë„ íšŒì „ (ë„ˆë¹„/ë†’ì´ëŠ” 16ì˜ ë°°ìˆ˜ì—¬ì•¼ í•¨)
Rotate image 90 deg clockwise	ì´ë¯¸ì§€ë¥¼ ì‹œê³„ ë°©í–¥ìœ¼ë¡œ 90ë„ íšŒì „
Rotate image 90 deg counter-clockwise	ì´ë¯¸ì§€ë¥¼ ì‹œê³„ ë°˜ëŒ€ ë°©í–¥ìœ¼ë¡œ 90ë„ íšŒì „
Rotate image and fit to screen	ì´ë¯¸ì§€ë¥¼ íšŒì „í•˜ê³  í™”ë©´ì— ë§ì¶”ê¸°
Rotate image by user-defined angle	ì‚¬ìš©ì ì •ì˜ ê°ë„ë¡œ ì´ë¯¸ì§€ íšŒì „
Rotate the image by dragging with the mouse.	ë§ˆìš°ìŠ¤ë¡œ ëŒì–´ì„œ ì´ë¯¸ì§€ë¥¼ íšŒì „í•©ë‹ˆë‹¤.
SIMD mode used	ì‚¬ìš©ëœ SIMD ëª¨ë“œ
Same as Image	ì´ë¯¸ì§€ì™€ ë™ì¼
Saturation	ì±„ë„
Save	ì €ì¥
Save (%s)/ delete (%s) image processing parameters in/from parameter DB	ì´ë¯¸ì§€ ì²˜ë¦¬ ë§¤ê°œë³€ìˆ˜ë¥¼ DBì— ì €ì¥/ ì‚­ì œ(%s)
Save as (in screen size/resolution)	ë‹¤ë¥¸ ì´ë¦„ìœ¼ë¡œ ì €ì¥ (í™”ë©´ í¬ê¸°/í•´ìƒë„)
Save as template	í…œí”Œë¦¿ìœ¼ë¡œ ì €ì¥
Save cropped image	ì˜ë¼ë‚¸ ì´ë¯¸ì§€ ì €ì¥
Save processed image to JPEG file (original size)	ì²˜ë¦¬ëœ ì´ë¯¸ì§€ë¥¼ JPEG íŒŒì¼ì— ì €ì¥ (ì›ë³¸ í¬ê¸°)
Save processed image to JPEG file (screen size)	ì²˜ë¦¬ëœ ì´ë¯¸ì§€ë¥¼ JPEG íŒŒì¼ì— ì €ì¥ (í™”ë©´ í¬ê¸°)
Save to	ë‹¤ë¥¸ ì´ë¦„ìœ¼ë¡œ ì €ì¥
Scaling mode:	ë°°ìœ¨ ëª¨ë“œ:
Screen Pixels	í™”ë©´ í”½ì…€
Scroll from bottom	ì•„ë˜ì—ì„œ ìŠ¤í¬ë¡¤
Scroll from left	ì™¼ìª½ì—ì„œ ìŠ¤í¬ë¡¤
Scroll from right	ì˜¤ë¥¸ìª½ì—ì„œ ìŠ¤í¬ë¡¤
Scroll from top	ìœ„ì—ì„œ ìŠ¤í¬ë¡¤
Select Printer...	í”„ë¦°í„° ì„ íƒ...
Select all	ëª¨ë‘ ì„ íƒ
Select application	ì‘ìš© í”„ë¡œê·¸ë¨ ì„ íƒ
Select file to display in 'File Open' dialog	'íŒŒì¼ ì—´ê¸°' ëŒ€í™” ìƒìì— í‘œì‹œí•  íŒŒì¼ ì„ íƒ
Select none	ì„ íƒ ì—†ìŒ
Select parameter DB to restore	ë³µì›í•  ë§¤ê°œë³€ìˆ˜ DB ì„ íƒ
Set Fixed Crop Size	ê³ ì •ëœ ìë¥´ê¸° í¬ê¸° ì„¤ì •
Set JPEGView as default image viewer	JPEGViewë¥¼ ê¸°ë³¸ ì´ë¯¸ì§€ ë·°ì–´ë¡œ ì„¤ì •
Set timeout to n/10 sec, respectively n/100 sec (Ctrl+Shift)	ì‹œê°„ ì´ˆê³¼ë¥¼ ê°ê° n/10ì´ˆ, n/100ì´ˆë¡œ ì„¤ì • (Ctrl+Shift)
Shall existing entries be preserved (Yes) or be overriden by the imported entries (No)?	ê¸°ì¡´ í•­ëª©ì„ ë³´ì¡´í•´ì•¼ í•©ë‹ˆê¹Œ (ì˜ˆ) ì•„ë‹ˆë©´ ê°€ì ¸ì˜¨ í•­ëª©ìœ¼ë¡œ ì¬ì •ì˜í•´ì•¼ í•©ë‹ˆê¹Œ (ì•„ë‹ˆì˜¤)?
Sharpen	ì„ ëª…í•˜ê²Œ
Sharpen low	ë‚®ê²Œ ì„ ëª…í•˜ê²Œ
Sharpen medium	ì¤‘ê°„ ì„ ëª…í•˜ê²Œ
Shortcut Help	ë°”ë¡œê°€ê¸° ë„ì›€ë§	
Shortcut key:	ë°”ë¡œê°€ê¸° í‚¤
Show filename	íŒŒì¼ ì´ë¦„ í‘œì‹œ
Show first image in folder	í´ë”ì—ì„œ ì²« ë²ˆì§¸ ì´ë¯¸ì§€ í‘œì‹œ
Show grid lines	ì•ˆë‚´ì„  í‘œì‹œ
Show histogram	íˆìŠ¤í† ê·¸ë¨ í‘œì‹œ
Show last image in folder	í´ë”ì—ì„œ ë§ˆì§€ë§‰ ì´ë¯¸ì§€ í‘œì‹œ
Show navigation panel	íƒìƒ‰ íŒ¨ë„ í‘œì‹œ
Show next image	ë‹¤ìŒ ì´ë¯¸ì§€ í‘œì‹œ
Show picture info (EXIF)	ì‚¬ì§„ ì •ë³´ í‘œì‹œ (EXIF)
Show previous image	ì´ì „ ì´ë¯¸ì§€ í‘œì‹œ
Show/hide file name	íŒŒì¼ ì´ë¦„ í‘œì‹œ/ìˆ¨ê¸°ê¸°
Show/hide navigation panel	íƒìƒ‰ íŒ¨ë„ í‘œì‹œ/ìˆ¨ê¸°ê¸°
Show/hide picture information (EXIF data)	ì‚¬ì§„ ì •ë³´ (EXIF) í‘œì‹œ/ìˆ¨ê¸°ê¸°
Show/hide this help text	ì´ ë„ì›€ë§ í…ìŠ¤íŠ¸ í‘œì‹œ/ìˆ¨ê¸°ê¸°
Size:	í¬ê¸°
Slide from bottom	ì•„ë˜ì—ì„œ ìŠ¬ë¼ì´ë“œ
Slide from left	ì•„ë˜ì—ì„œ ìŠ¬ë¼ì´ë“œ
Slide from right	ì˜¤ë¥¸ìª½ì—ì„œ ìŠ¬ë¼ì´ë“œ
Slide from top	ìœ„ì—ì„œ ìŠ¬ë¼ì´ë“œ
Slideshow	ìŠ¬ë¼ì´ë“œ ì‡¼
Slideshow with timeout of 'n' seconds (ESC to stop)	ì‹œê°„ ì´ˆê³¼ê°€ 'n'ì´ˆì¸ ìŠ¬ë¼ì´ë“œ ì‡¼ (ESCë¡œ ì¤‘ì§€)
Sort images by creation date, resp. modification date, resp. file name	ë§Œë“  ë‚ ì§œ, ìˆ˜ì • ë‚ ì§œ, íŒŒì¼ ì´ë¦„ ìˆœìœ¼ë¡œ ì •ë ¬
Source:	ì›ë³¸
Target folders that do not yet exist are created as needed.	ì•„ì§ ì¡´ì¬í•˜ì§€ ì•ŠëŠ” ëŒ€ìƒ í´ë”ê°€ í•„ìš”ì— ë”°ë¼ ìƒì„±ë©ë‹ˆë‹¤.
The directory '%s' does not contain any image files!	'%s' ë””ë ‰í„°ë¦¬ì— ì´ë¯¸ì§€ íŒŒì¼ì´ ì—†ìŠµë‹ˆë‹¤!
The file '%s' could not be copied!	%s' íŒŒì¼ì„ ë³µì‚¬í•  ìˆ˜ ì—†ìŠµë‹ˆë‹¤!
The file '%s' could not be read!	'%s' íŒŒì¼ì„ ì½ì„ ìˆ˜ ì—†ìŠµë‹ˆë‹¤!
The file '%s' could not be renamed!	'%s' íŒŒì¼ì˜ ì´ë¦„ì„ ë°”ê¿€ ìˆ˜ ì—†ìŠµë‹ˆë‹¤!
The file '%s' does not contain a list of file names!	''%s' íŒŒì¼ì— íŒŒì¼ ì´ë¦„ ëª©ë¡ì´ ì—†ìŠµë‹ˆë‹¤!
The file is read-only!	íŒŒì¼ì´ ì½ê¸° ì „ìš©ì…ë‹ˆë‹¤!
The following file extensions cannot be unregistered because they have been registered in the 'local machine' registry area.	ë‹¤ìŒ íŒŒì¼ í™•ì¥ì§€ëŠ” 'ë¡œì»¬ ì»´í“¨í„°' ë ˆì§€ìŠ¤íŠ¸ë¦¬ ì˜ì—­ì— ë“±ë¡ë˜ì–´ ìˆìœ¼ë¯€ë¡œ ë“±ë¡ì„ ì·¨ì†Œí•  ìˆ˜ ì—†ìŠµë‹ˆë‹¤.
The following image extensions are protected by the operating system.	ë‹¤ìŒ ì´ë¯¸ì§€ í™•ì¥ìëŠ” ìš´ì˜ ì²´ì œì— ì˜í•´ ë³´í˜¸ë©ë‹ˆë‹¤
The imported param DB contains entries already present in active param DB.	ê°€ì ¸ì˜¨ ë§¤ê°œë³€ìˆ˜ DBì— í™œì„± ë§¤ê°œë³€ìˆ˜ DBì— ì´ë¯¸ ìˆëŠ” í•­ëª©ì´ ìˆìŠµë‹ˆë‹¤.
The new size is too large - width or height is larger than 65535 or total number of pixels is too large!	ìƒˆ í¬ê¸°ê°€ ë„ˆë¬´ í½ë‹ˆë‹¤. ë„ˆë¹„ ë˜ëŠ” ë†’ì´ê°€ 65535ë³´ë‹¤ í¬ê±°ë‚˜ ì´ í”½ì…€ ìˆ˜ê°€ ë„ˆë¬´ í½ë‹ˆë‹¤!
The old parameter DB file '%s' could not be renamed during conversion to new format!	ìƒˆ í˜•ì‹ìœ¼ë¡œ ë³€í™˜í•˜ëŠ” ë™ì•ˆ ì´ì „ ë§¤ê°œë³€ìˆ˜ DB íŒŒì¼ '%s'ì˜ ì´ë¦„ì„ ë°”ê¿€ ìˆ˜ ì—†ìŠµë‹ˆë‹¤!
The operation failed because not enough memory is available!	ì‚¬ìš© ê°€ëŠ¥í•œ ë©”ëª¨ë¦¬ê°€ ë¶€ì¡±í•˜ì—¬ ì‘ì—…ì— ì‹¤íŒ¨í–ˆìŠµë‹ˆë‹¤!
The parameter DB file '%s' has been created by a newer version of JPEGView!	ë§¤ê°œë³€ìˆ˜ DB íŒŒì¼ '%s'ì´(ê°€) ìµœì‹  ë²„ì „ì˜ JPEGViewì—ì„œ ìƒì„±ë˜ì—ˆìŠµë‹ˆë‹¤!
The transformation can be applied if the image is trimmed to the next matching size but this will remove some border pixels.	ì´ë¯¸ì§€ê°€ ë‹¤ìŒ ì¼ì¹˜ í¬ê¸°ë¡œ ì˜ë¦° ê²½ìš° ë³€í™˜ì„ ì ìš©í•  ìˆ˜ ìˆì§€ë§Œ, ì´ë ‡ê²Œ í•˜ë©´ ì¼ë¶€ í…Œë‘ë¦¬ í”½ì…€ì´ ì œê±°ë©ë‹ˆë‹¤.
These values will override the values from the INI file located in the program folder of JPEGView!	ì´ëŸ¬í•œ ê°’ì€ JPEG Viewì˜ í”„ë¡œê·¸ë¨ í´ë”ì— ìˆëŠ” INI íŒŒì¼ì˜ ê°’ì„ ì¬ì •ì˜í•©ë‹ˆë‹¤!
Threshold	ì„ê³„ê°’
Title:	ì œëª©
Toggle between screens (only for multi-monitor systems)	í™”ë©´ ì „í™˜ (ë‹¤ì¤‘ ëª¨ë‹ˆí„° ì‚¬ìš©ì‹œ)
Toggle window always on top mode	ì°½ì„ í•­ìƒ ë§¨ ìœ„ ëª¨ë“œë¡œ ì „í™˜
Toggle window title bar hidden mode	ì°½ ì œëª© í‘œì‹œì¤„ ìˆ¨ê¹€ ëª¨ë“œ ì „í™˜
Top	ë§¨ ìœ„
Transition Effect	ì „í™˜ íš¨ê³¼
Trim the image and apply transformation? Trimming cannot be undone!	ì´ë¯¸ì§€ë¥¼ íŠ¸ë¦¬ë°í•˜ê³  ë³€í™˜ì„ ì ìš©í•˜ì‹œê² ìŠµë‹ˆê¹Œ? íŠ¸ë¦¬ë°ì€ ë˜ëŒë¦´ ìˆ˜ ì—†ìŠµë‹ˆë‹¤!
Unregistering not possible	ë“±ë¡ ì·¨ì†Œí•  ìˆ˜ ì—†ìŠµë‹ˆë‹¤
Unsharp mask...	ì„ ëª…í•˜ì§€ ì•Šì€ ë§ˆìŠ¤í¬...
Update user settings with new settings from settings template file?	ì„¤ì • í…œí”Œë¦¿ íŒŒì¼ì˜ ìƒˆ ì„¤ì •ìœ¼ë¡œ ì‚¬ìš©ì ì„¤ì •ì„ ì—…ë°ì´íŠ¸í•˜ì‹œê² ìŠµë‹ˆê¹Œ?
Use the 'Default Programs' configuration dialog from the operating system instead.	ëŒ€ì‹  ìš´ì˜ ì²´ì œì˜ 'ê¸°ë³¸ í”„ë¡œê·¸ë¨' êµ¬ì„± ëŒ€í™” ìƒìë¥¼ ì‚¬ìš©í•˜ì‹­ì‹œì˜¤.
Use the mouse to draw a line that shall be horizontal or vertical.	ë§ˆìš°ìŠ¤ë¥¼ ì‚¬ìš©í•˜ì—¬ ìˆ˜í‰ ë˜ëŠ” ìˆ˜ì§ìœ¼ë¡œ ì„ ì„ ê·¸ë¦½ë‹ˆë‹¤.
Warning	ê²½ê³ 
Width	ë„ˆë¹„
Window mode	ì°½ ëª¨ë“œ
Windows 8 (and above) blocks JPEGView from changing the default program for these file extensions.	Windows 8 ì´ìƒì—ì„œëŠ” JPEG Viewê°€ ì´ëŸ¬í•œ íŒŒì¼ í™•ì¥ìì˜ ê¸°ë³¸ í”„ë¡œê·¸ë¨ì„ ë³€ê²½í•˜ì§€ ëª»í•˜ë„ë¡ ì°¨ë‹¨í•©ë‹ˆë‹¤.
Writing the resulting JPEG file to disk failed	ê²°ê³¼ JPEG íŒŒì¼ì„ ë””ìŠ¤í¬ì— ì“°ì§€ ëª»í–ˆìŠµë‹ˆë‹¤
Y - B	Y - B
Year short form (2 digits)	ì—°ë„ ë‹¨ì¶• í˜•ì‹ (2 ìë¦¬)
Yellow-Blue	ë…¸ë‘-íŒŒë‘
Zoom 1:1 (100 %)	1:1 ë°°ìœ¨ (100 %)
Zoom in (%s)/Zoom out (%s)	í™•ëŒ€ (%s)/ì¶•ì†Œ (%s)
Zoom in/out image	í™•ëŒ€/ì¶•ì†Œ
Zoom mode (drag mouse to zoom)	í™•ëŒ€/ì¶•ì†Œ ëª¨ë“œ(ë§ˆìš°ìŠ¤ë¥¼ ëŒì–´ í™•ëŒ€/ì¶•ì†Œ)
and image processing (brightness/contrast/sharpen) parameters between images	ë° ì˜ìƒ ê°„ ì˜ìƒ ì²˜ë¦¬ (ë°ê¸°/íœ˜ë„/íœ˜ë„) ë§¤ê°œë³€ìˆ˜
cm	ì„¼í‹°ë¯¸í„°
in	ì¸ì¹˜
new menu entry	ìƒˆ ë©”ë‰´ í•­ëª©
no	ì•„ë‹ˆì˜¤
off	ë„ê¸°
on	ì¼œê¸°
user-defined	ì‚¬ìš©ì ì •ì˜
yes	ì˜ˆ

// ::: Popup Menu Strings ::: (unsorted to preserve context) //
Stop slide show/movie	ìŠ¬ë¼ì´ë“œ ì‡¼/ë™ì˜ìƒ ì¤‘ì§€
Open image...	ì´ë¯¸ì§€ ì—´ê¸°...
Open image with	ë‹¤ìŒìœ¼ë¡œ ì´ë¯¸ì§€ ì—´ê¸°
Save processed image...	ì²˜ë¦¬ëœ ì´ë¯¸ì§€ ì €ì¥...
Reload image	ì´ë¯¸ì§€ ë‹¤ì‹œ ë¶ˆëŸ¬ì˜¤ê¸°
Open containing folder in Explorer	íƒìƒ‰ê¸°ì—ì„œ í¬í•¨ëœ í´ë” ì—´ê¸°
Print image...	ì´ë¯¸ì§€ ì¸ì‡„
Batch rename/copy...	ì¼ê´„ ì´ë¦„ ë°”ê¾¸ê¸°/ë³µì‚¬...
Set modification date	ìˆ˜ì • ë‚ ì§œ ì„¤ì •
to current date	í˜„ì¬ ë‚ ì§œë¡œ
to EXIF date	EXIF ë‚ ì§œë¡œ
to EXIF date (all files in folder)	EXIF ë‚ ì§œ (í´ë”ì˜ ëª¨ë“  íŒŒì¼)
Set as desktop wallpaper	ë°”íƒ•í™”ë©´ ë°°ê²½í™”ë©´ìœ¼ë¡œ ì„¤ì •
Use original image	ì›ë³¸ ì´ë¯¸ì§€ ì‚¬ìš©
Use processed image as displayed	í‘œì‹œëœ ëŒ€ë¡œ ì²˜ë¦¬ëœ ì´ë¯¸ì§€ ì‚¬ìš©
Copy to clipboard	í´ë¦½ë³´ë“œì— ë³µì‚¬
Copy original size image	ì›ë³¸ í¬ê¸° ì´ë¯¸ì§€ ë³µì‚¬
Copy file path	íŒŒì¼ ê²½ë¡œ ë³µì‚¬
Display order	í‘œì‹œ ìˆœì„œ
Modification date	ìˆ˜ì • ë‚ ì§œ
Creation date	ë§Œë“  ë‚ ì§œ
Play folder as slideshow/movie	ìŠ¬ë¼ì´ë“œ ì‡¼/ë™ì˜ìƒìœ¼ë¡œ ì¬ìƒ
Waiting time	ëŒ€ê¸° ì‹œê°„
1 sec	1ì´ˆ
2 sec	2ì´ˆ
3 sec	3ì´ˆ
4 sec	4ì´ˆ
5 sec	5ì´ˆ
7 sec	7ì´ˆ
10 sec	10ì´ˆ
20 sec	20ì´ˆ
Transition Speed	ì „í™˜ ì†ë„
Very fast	ë§¤ìš° ë¹ ë¦„
Fast	ë¹ ë¦„
Normal	ë³´í†µ
Slow	ëŠë¦¬
Very slow	ë§¤ìš° ëŠë¦¼
Movie	ë™ì˜ìƒ
Playback speed	ì¬ìƒ ì†ë„
5 fps	5 fps
10 fps	10 fps
25 fps	25 fps
30 fps	30 fps
50 fps	50 fps
100 fps	100 fps
Transform image	ì´ë¯¸ì§€ ë³€í™˜
Rotate +90	+90 íšŒì „
Rotate -90	-90 íšŒì „
Rotate...	íšŒì „
Change size...	í¬ê¸° ë³€ê²½..
Perspective correction...	ì›ê·¼ ë³´ì •...
Mirror horizontally	ìˆ˜í‰ìœ¼ë¡œ ëŒ€ì¹­
Mirror vertically	ìˆ˜ì§ìœ¼ë¡œ ëŒ€ì¹­
Rotate 180	180 íšŒì „
Auto correction	ìë™ ë³´ì •
Save parameters to DB	DBì— ë§¤ê°œë³€ìˆ˜ ì €ì¥
Clear parameters from DB	DBì—ì„œ ë§¤ê°œë³€ìˆ˜ ì§€ìš°ê¸°
Zoom	í™•ëŒ€/ì¶•ì†Œ
Span all screens	ëª¨ë“  í™”ë©´ìœ¼ë¡œ ëŠ˜ë¦¬ê¸°
Fit window to image	ì´ë¯¸ì§€ì— ì°½ ë§ì¶¤
Hide window title bar	ì°½ ì œëª© í‘œì‹œì¤„ ìˆ¨ê¸°ê¸°
Set window always on top	ì°½ì„ í•­ìƒ ë§¨ ìœ„ì— ì„¤ì •
Settings/Admin	ì„¤ì •/ê´€ë¦¬ì
Edit global settings...	ì „ì—­ ì„¤ì • í¸ì§‘...
Edit user settings...	ì‚¬ìš©ì ì„¤ì • í¸ì§‘...
Update user settings...	ì‚¬ìš©ì ì„¤ì • ì—…ë°ì´íŠ¸...
Set current parameters as default values...	í˜„ì¬ ë§¤ê°œë³€ìˆ˜ë¥¼ ê¸°ë³¸ê°’ìœ¼ë¡œ ì„¤ì •...
Set as default viewer...	ê¸°ë³¸ ë·°ì–´ë¡œ ì„¤ì •...
Backup parameter DB...	ë§¤ê°œë³€ìˆ˜ DB ë°±ì—…
Restore parameter DB...	ë§¤ê°œë³€ìˆ˜ DB ë³µì›
User commands	ì‚¬ìš©ì ëª…ë ¹
About JPEGView...	JPEGView ì •ë³´...
Exit	ì¢…ë£Œ
Crop Selection	ì„ íƒ ì˜ì—­ ìë¥´ê¸°
Crop Selection Lossless...	ì„ íƒ ì˜ì—­ ë¬´ì†ì‹¤ ìë¥´ê¸°
Copy Selection to Clipboard	ì„ íƒ ì˜ì—­ì„ í´ë¦½ë³´ë“œë¡œ ë³µì‚¬
Crop Mode	ìë¥´ê¸° ëª¨ë“œ
Free	ììœ 
Fixed size...	ê³ ì •ëœ í¬ê¸°...
Zoom to Selection	ì„ íƒ ì˜ì—­ìœ¼ë¡œ í™•ëŒ€
